{

  "columns":12,

  "graphics_map":[48,17,17,17,49,48,18,19,16,17,35,36,
                  10,39,39,39,16,18,39,31,31,31,39, 7,
                  10,31,39,31,31,31,39,12, 5, 5,28, 1,
                  35, 6,39,39,31,39,39,19,39,39, 8, 9,
                   2,31,31,47,39,47,39,31,31, 4,36,25,
                  10,39,39,31,39,39,39,31,31,31,39,37,
                  10,39,31, 4,14, 6,39,39, 3,39, 0,42,
                  49, 2,31,31,11,39,39,31,11, 0,42, 9,
                   8,40,27,13,37,27,13, 3,22,34, 9,24],

  "collision_map":[ 0, 4, 4, 4, 0, 0, 4, 4, 4, 4, 4, 0,
                    2, 0, 0, 0,12, 6, 0, 0, 0, 0, 0, 8,
                    2, 0, 0, 0, 0, 0, 0, 9, 5, 5, 1, 0,
                    0, 7, 0, 0, 0, 0, 0,14, 0, 0, 8, 0,
                    2, 0, 0, 1, 0, 1, 0, 0, 0,13, 4, 0,
                    2, 0, 0, 0, 0, 0, 0, 0, 0, 0, 0, 8,
                    2, 0, 0,13, 1, 7, 0, 0,11, 0, 9, 0,
                    0, 3, 0, 0,10, 0, 0, 0, 8, 1, 0, 0,
                    0, 0, 1, 1, 0, 1, 1, 1, 0, 0, 0, 0],

  "tile_set":"rabbit-trap-tileset.json"

}
