{

  "assets":["Dirt", "Guy"],

  "world":[],

  "players":[
  
    ["Guy", 24, 24, 0]
  
  ],
  
  "tiles":[
    
    ["Dirt", 0],
    ["Dirt", 1],
    ["Dirt", 2]
  
  ],

  "map":[
    
    40, 40,
    
    [ ["Start Room",             0,   0, 160,  48, 112,  48,   8,   8, 112,   8, 112,  40,   8,  40],
      ["Long Duct",            112,   0,  56, 208,  56, 96, 112,   0, 160,    0, 160, 24, 160, 56, 152, 56, 152, 176, 128, 176, 128, 40, 112, 40],
      ["Platform Room",        112,   0, 208,  64,  96,  64, 160,   8, 312,   8, 312,  56, 160,  56],
      ["Hole In The Floor",      0,  40, 136, 104, 136, 104,   8,  48, 120,  48, 120, 112, 128, 112, 128, 136,   8, 136],
      ["Save Room",            128,  56,  64,  40,  64,  40, 152,  64, 184,  64, 184,  88, 152,  88],
      ["Under The Save Room",  144,  56, 176, 104, 176, 104, 192,  64, 312,  64, 312, 152, 296, 152, 296, 160, 280, 160, 280, 152, 152, 152, 152, 128, 160, 128, 160, 96, 192, 96],
      ["Master Room",            0, 128, 272, 192, 272, 192,  24, 128,  48, 128, 128, 152, 128, 176, 152, 176, 152, 160, 264, 160, 264, 272, 176, 288, 152, 312,   8, 312,   8, 144],
      ["Lower Duct",           256, 112,  64, 208,  64,  84, 272, 160, 296, 160, 296, 312, 272, 288],
      ["Master Hall",          128, 272, 192,  48, 128,  48, 176, 288, 272, 288, 296, 312, 152, 312]],

    [ 1,1,1,2,1,2,1,1,1,2,1,1,1,2,1,2,2,0,0,1,2,1,1,1,1,1,1,1,1,2,2,1,2,1,1,1,1,1,1,1,
      1,2,2,2,0,2,0,2,2,0,2,2,0,2,2,2,0,0,1,1,2,1,0,0,0,0,0,0,0,0,2,0,0,2,1,1,0,1,1,1,
      1,2,0,0,0,0,0,2,0,0,0,0,2,0,0,0,0,0,1,1,0,0,0,0,0,0,0,0,0,0,0,0,0,0,1,0,0,0,0,1,
      2,0,0,0,0,0,0,0,0,0,0,0,0,0,0,0,0,0,0,2,0,0,0,0,0,0,0,0,0,0,0,0,0,0,0,0,0,0,0,1,
      1,0,0,0,0,0,0,0,0,0,0,0,0,0,0,0,0,0,0,0,0,0,0,0,0,0,1,1,1,0,0,0,0,0,0,0,0,0,0,1,
      1,1,1,1,1,1,1,1,1,1,1,1,1,1,1,1,0,0,0,0,0,0,0,0,0,1,2,1,2,1,0,0,0,0,0,0,0,0,0,1,
      2,1,0,1,0,1,1,2,1,0,2,2,1,1,2,1,0,0,0,0,0,0,0,0,1,2,1,2,1,2,1,0,0,0,0,0,0,0,1,1,
      1,1,0,0,0,0,0,0,0,1,2,0,1,2,2,1,0,0,1,1,1,1,1,1,2,1,2,1,2,1,2,2,2,1,2,1,1,1,1,1,
      1,0,0,0,0,0,0,0,0,0,2,1,0,0,0,1,0,0,0,0,2,0,0,1,0,2,2,1,2,0,0,2,0,2,0,1,2,1,1,1,
      1,0,0,0,0,0,0,0,0,0,0,0,0,0,0,1,1,0,0,0,0,0,0,1,0,1,0,0,0,0,0,0,0,0,0,2,0,1,0,1,
      1,1,0,0,0,0,0,0,0,0,0,0,0,0,1,1,0,0,0,0,0,0,0,1,1,0,0,0,0,0,0,0,0,0,0,0,0,0,1,1,
      1,0,1,0,0,0,0,0,0,0,0,0,0,0,1,1,0,0,1,1,1,1,1,1,0,0,0,0,0,0,0,0,0,0,0,0,0,0,1,1,
      2,1,0,0,0,0,0,0,0,0,0,0,0,0,0,1,0,0,0,1,2,1,0,0,0,0,0,0,0,0,0,0,0,0,0,0,0,0,0,1,
      2,1,0,0,0,0,0,0,1,1,0,0,0,0,0,1,1,0,0,1,1,0,0,0,0,0,0,0,0,0,0,0,0,0,0,0,0,0,0,1,
      1,1,0,0,0,0,0,0,0,0,0,0,0,0,0,0,0,0,0,1,0,0,0,0,0,0,0,0,0,0,0,0,0,0,0,0,0,0,1,1,
      1,0,1,0,0,0,0,0,0,0,0,0,0,0,0,0,0,0,1,1,0,0,0,0,0,0,0,0,0,0,0,0,0,0,0,0,0,0,1,1,
      1,0,1,0,0,0,1,1,1,1,1,1,1,1,0,0,0,0,0,0,0,0,0,0,0,0,0,0,0,0,0,0,0,0,0,0,0,0,0,1,
      1,1,1,1,0,0,0,0,0,1,1,1,1,1,1,1,1,0,0,0,0,0,0,0,0,0,0,0,0,0,0,0,0,0,0,0,0,0,0,1,
      1,0,0,0,0,0,0,0,0,0,0,0,2,2,2,1,1,0,0,0,0,0,1,1,1,1,1,1,1,0,0,0,0,0,0,0,0,0,1,1,
      1,1,0,0,0,0,0,0,0,0,0,0,0,2,0,0,0,0,1,1,1,1,1,1,1,1,1,1,1,1,1,1,1,1,1,0,0,1,1,1,
      1,1,1,1,1,1,1,0,0,0,0,0,0,0,0,0,0,0,0,0,1,2,0,0,0,0,2,1,2,1,0,1,1,1,0,0,0,1,1,1,
      1,0,1,0,0,0,0,0,0,0,0,0,0,0,0,0,0,0,0,0,0,2,0,0,0,0,0,0,2,1,0,0,1,1,0,0,1,1,1,1,
      1,1,1,0,0,0,0,0,0,0,0,0,0,0,0,0,1,1,1,0,0,0,0,0,0,0,0,0,2,2,1,1,1,1,0,0,0,1,1,1,
      1,1,0,0,0,0,0,0,0,0,0,0,0,0,0,1,1,2,0,0,0,0,0,0,0,0,0,0,0,2,0,0,1,1,1,0,0,1,1,1,
      1,1,0,0,0,0,0,0,0,0,0,0,0,0,0,0,2,2,0,0,0,0,0,0,0,0,0,0,0,0,0,0,0,1,0,0,0,1,1,1,
      1,0,0,0,0,0,0,0,1,1,1,1,1,0,0,0,0,0,0,0,1,1,1,1,1,1,0,0,0,0,0,0,0,1,0,0,1,1,1,1,
      1,0,0,0,0,0,0,0,0,2,2,0,0,0,0,0,0,0,0,0,0,2,0,0,2,2,0,0,0,0,0,0,1,1,0,0,0,1,1,1,
      1,0,0,0,0,0,0,0,0,0,2,0,0,0,0,0,0,0,0,0,0,0,0,0,0,2,0,0,0,0,0,0,1,1,1,0,0,1,1,1,
      1,0,0,0,1,1,1,2,0,0,0,0,0,0,0,0,0,0,0,0,0,0,0,0,0,0,0,0,0,0,0,0,0,1,0,0,0,1,1,1,
      1,0,0,0,0,0,2,0,0,0,0,0,0,0,0,0,0,0,0,0,0,0,0,0,0,0,0,0,0,0,0,0,0,1,0,0,1,1,1,1,
      1,0,0,0,0,0,0,0,0,0,0,0,0,0,0,0,0,0,0,0,0,0,0,0,0,0,0,0,0,0,0,0,0,1,0,0,0,1,1,1,
      1,1,1,0,0,0,0,0,0,0,0,0,0,0,0,0,0,0,0,0,0,0,0,0,0,0,0,0,0,0,0,0,0,1,1,0,0,1,1,1,
      1,0,0,0,0,0,0,0,0,0,0,0,0,0,0,0,0,0,0,0,0,0,0,0,0,0,0,0,0,0,0,0,0,1,0,0,0,1,1,1,
      1,0,0,1,1,1,0,0,0,0,0,0,0,0,0,0,0,0,0,0,0,0,0,0,0,0,0,0,0,0,0,0,2,1,0,0,1,1,1,1,
      1,0,0,0,0,2,0,0,0,0,0,0,0,0,0,0,0,0,0,0,0,0,0,0,1,1,1,1,1,1,1,2,2,1,0,0,0,1,1,1,
      1,1,0,0,0,0,0,0,0,0,0,0,0,0,0,0,0,0,0,0,0,0,2,1,1,1,1,1,1,1,1,1,1,1,1,0,0,1,1,1,
      1,1,1,0,0,0,0,1,1,1,0,0,0,0,0,0,0,0,0,0,0,0,0,0,0,2,0,0,0,0,0,0,0,0,0,0,0,1,1,1,
      1,2,0,1,0,0,0,0,0,0,0,0,0,0,0,0,0,0,0,0,0,0,0,0,0,0,0,0,0,0,0,0,0,0,0,0,1,1,2,2,
      1,2,0,2,1,1,0,0,0,0,0,0,0,0,0,0,0,0,0,0,0,0,0,0,0,0,0,0,0,0,0,0,0,0,0,1,1,2,2,2,
      2,1,2,1,1,1,1,1,1,1,1,1,1,1,1,1,1,1,1,1,1,1,1,1,1,1,1,1,1,1,1,1,1,1,1,1,2,2,1,1]

  ]

}